0;0;0;0;0;0;0;0;0;0;0;0;0;0;0;0
0;1;1;-1;-1;-1;1;0;1;36;-1;-1;-1;-1;-1;0
0;1;-1;-1;-1;-1;-1;0;-1;-1;-1;-1;-1;-1;-1;0
0;-1;-1;-1;-1;-1;-1;0;-1;-1;-1;0;-1;-1;-1;0
0;-1;-1;35;-1;-1;-1;0;-1;-1;-1;0;-1;47;-1;0
0;-1;-1;-1;-1;-1;-1;0;-1;-1;-1;0;-1;-1;-1;0
0;-1;-1;1;0;-1;-1;0;-1;-1;-1;0;0;0;0;0
0;-1;-1;-1;0;-1;-1;-1;-1;-1;-1;-1;-1;-1;1;0
0;-1;-1;-1;0;-1;-1;-1;-1;-1;-1;-1;-1;-1;-1;0
0;-1;45;-1;0;1;-1;-1;-1;-1;-1;-1;-1;34;-1;0
0;-1;-1;-1;0;1;1;-1;-1;-1;-1;-1;-1;-1;-1;0
0;0;0;0;0;0;0;0;0;0;0;0;0;0;0;0
