0;0;0;0;0;0;0;0;0;0;0;0;0;0;0;0
0;-1;-1;-1;-1;-1;-1;0;-1;-1;0;-1;-1;0;-1;0
0;-1;34;-1;-1;-1;-1;0;-1;37;0;-1;-1;38;-1;0
0;-1;-1;-1;1;1;-1;1;-1;-1;1;-1;-1;-1;-1;0
0;-1;-1;-1;1;1;-1;-1;-1;-1;-1;-1;-1;-1;-1;0
0;0;-1;-1;-1;-1;-1;-1;-1;-1;-1;-1;1;1;-1;0
0;0;-1;-1;-1;-1;-1;-1;-1;-1;-1;-1;1;1;-1;0
0;1;1;-1;-1;-1;-1;-1;1;1;1;-1;-1;-1;-1;0
0;1;1;1;-1;-1;1;-1;1;1;1;-1;-1;-1;-1;0
0;45;-1;-1;-1;-1;0;-1;-1;-1;-1;-1;-1;47;-1;0
0;1;1;1;1;1;0;-1;-1;-1;-1;-1;-1;-1;-1;0
0;0;0;0;0;0;0;0;0;0;0;0;0;0;0;0
