0;0;0;0;0;0;0;0;0;0;0;0;0;0;0;0
0;1;-1;-1;-1;-1;-1;-1;-1;-1;1;1;-1;1;1;0
0;-1;34;-1;-1;-1;-1;-1;-1;-1;1;1;-1;45;1;0
0;1;-1;-1;-1;-1;-1;-1;-1;-1;-1;1;-1;-1;-1;0
0;1;1;-1;-1;-1;1;1;-1;37;-1;1;-1;-1;-1;0
0;0;0;0;0;0;0;0;-1;-1;-1;-1;-1;-1;-1;0
0;0;0;0;0;0;0;0;-1;-1;-1;-1;-1;-1;-1;0
0;0;0;0;0;0;0;0;-1;-1;-1;-1;-1;-1;-1;0
0;0;0;0;0;0;0;0;1;-1;-1;38;-1;-1;-1;0
0;0;0;0;0;0;0;0;1;1;-1;-1;-1;47;-1;0
0;0;0;0;0;0;0;0;1;1;-1;-1;-1;-1;-1;0
0;0;0;0;0;0;0;0;0;0;0;0;0;0;0;0
